NO texture/q.xpm   
SO texture/rock.xpm     
WE texture/wood.xpm      
EA texture/wall.xpm  
F  35,23,150
C  32,23,2


1111111111111111111111111
1000000000110000000000001
1011000001110000000000001
10010000000000000000000011111111
