NO texture/q.xpm   
SO texture/rock.xpm     
WE texture/wood.xpm      
EA texture/wall.xpm  
F  35,23,150
C  32,23,2

1111111111111111111111111
1000000000110000000000001
1011000001110000000000001
10010000000000000000000011111111
111111111011000001110000000000001
100000000011000001110111110011111
10010000000000000000000011111111
111111111011000001110000000000001
100000000011000001110111110011111
10010000000000000000000011111111
111111111011000001110000000000001
100000000011000001110111110011111
10010000000000000000000011111111
111111111011000001110000000000001
100000000011000001110111110011111
10010000000000000000000011111111
111111111011000001110000000000001
100000000011000001110111110011111
10010000000000000000000011111111
111111111011000001110000000000001
100000000011000001110111110011111
10010000000000000000000011111111
111111111011000001110000000000001
100000000011000001110111110011111
10010000000000000000000011111111
111111111011000001110000000000001
100000000011000001110111110011111
10010000000000000000000011111111
111111111011000001110000000000001
100000000011000001110111110011111
10010000000000000000000011111111
111111111011000001110000000000001
100000000011000001110111110011111
10010000000000000000000011111111
111111111011000001110000000000001
100000000011000001110111110011111
10010000000000000000000011111111
111111111011000001110000000000001
100000000011000001110111110011111
10010000000000000000000011111111
111111111011000001110000000000001
100000000011000001110111110011111
10010000000000000000000011111111
111111111011000001110000000000001
100000000011000001110111110011111
10010000000000000000000011111111
111111111011000001110000000000001
100000000011000001110111110011111
10010000000000000000000011111111
111111111011000001110000000000001
100000000011000001110111110011111
10010000000000000000000011111111
111111111011000001110000000000001
100000000011000001110111110011111
10010000000000000000000011111111
111111111011000001110000000000001
100000000011000001110111110011111
10010000000000000000000011111111
111111111011000001110000000000001
100000000011000001110111110011111
10010000000000000000000011111111
111111111011000001110000000000001
100000000011000001110111110011111
10010000000000000000000011111111
111111111011000001110000000000001
100000000011000001110111110011111
10010000000000000000000011111111
111111111011000001110000000000001
100000000011000001110111110011111
10010000000000000000000011111111
111111111011000001110000000000001
100000000011000001110111110011111
10010000000000000000000011111111
111111111011000001110000000000001
100000000011000001110111110011111
10010000000000000000000011111111
111111111011000001110000000000001
100000000011000001110111110011111
10010000000000000000000011111111
111111111011000001110P10000000001
100000000011000001110111110011111
11000001110101011111011110N0111
11110111 1110101 101111010001
11111111 1111111 111111111111